XXXXXXXXXX
XOOOOOOOOX
XOXXXXXXOX
XOXXXXXXOX
XOXXXXXXOX
XPOOOOOOOX
XXXXXXXXXX