XXXXXXXXXXXX
XOOOOOOOOXOX
XOXXXXXXOXOX
XOXXXXXXOXOX
XOXXXXXXOXOX
XPOOOOOOOOOX
XXXXXXXXXXXX