XXXXXXXXXX
XXOOOOOOOX
XOOOXXOOOX
XOXOOOOOXX
XOOXOOOOOX
XXPOOOOOOX
XXXXXXXXXX